#######
#S#...#
#.#.#G#
#.....#
#######
